32,32
00000000110000000000000000000000
00000000111000000000000000000000
00001000110000000000000000000000
00000000110000000000000000000000
00000000010000000000000000000000
00001000011100000000000000000000
00000000011000000000000000000000
00001000001000000000000000000000
00000000100000000000000000000000
00000000000000000000000000000000
00001000001000000000000000000000
00000010000000000000111111111111
00000000000000000001111111111111
00010000000000000001100001000000
00000000100000000001001001000000
00000100000000000001001001000000
00000000000000000001001001000000
00000000000000000001001001000000
00000000000000000001001001000000
00000000000000000001001001000000
00000000000000000001001001000000
00000000000000000001001001000000
00000000000000000001001001000000
00000000000000000001001001000000
00000000000000000001001001000000
00000000000000000001001001000000
00000000000000000001001001000000
00000000000000000001001001000000
00000000000000000001001001000000
00000000000000000001001001000000
00000000000000000000001000000000
00000000000000000000001000000000
